💭💭💭💭💭💭🌳🌚🌳💚💼💭💭💭💭💭💭🌚💭💭🍪💭🌕🌳💭💭🌳🍪🍪🌳🍪💼🙊🙊🙊💼🙊💼🌳💭
💭💭💭💭💭💭💭🌳💼💭💭💭💭💭💭💭💭🌚💭🌳🌕💭🌚🍪❤💭💙🌚🌚🙊🙊💭🍪🍪💚🙊💼🍪🍪💭
💭💭💭💭💭💭💭💭💭🌕💭💚🌳🌳🌳🍪💚🐘💭💭💭💭💭💭💭🌚💭💭💭🌳⚪💭💚🌳🌳🌳🍪🙊🙊🙊
💭💭🐘💭💭💭💭🍪🌳🍪🍪🍪🍪🌳🌚🌚🌳💭💭💭💭💭💭💭💭💭💭💭💭💭💭💼🌚🍪🌳🌳🌳🌳🍪🙊
💭💭💭💭💭💭💚🍪💼🍪💼🍪💚🌳🌳🌳🌚💚🌳🌳💭💭🐘🙊💭💭💭🌕💭💭🐘🌳🍪🍪🍪🌳👕🌚🌚🍪
💭💭💭💭💭💭🍪🌳🍪🍪🌳🌚🌳🌳🌳🌳🌚🍪🍪🌳🌳💭⚪🌚🌳🌳🌚🌳🌳🌳💚🍪🍪🍪🍪🌳🌳🌳🌚💭
💭💭🌕💭💭🌳🌳🌳💚🍪🌳💚🌚🌳🌳🍪💚🍪💚🌳🌳🌳🌳🌳🌳🌳🌚🌳🌚🍪💭🍪🍪🍪🍪🍪🌳🌳🌳💭
💭💭💭🌳🌳🌳🌳💚🍪🌳🌳🌳🌳💚🌳🍪🌳💚🌚🎀💚🌳🌳🌳🌳🌳🌳🌳🌳🌚🌚💭🍪🍪🙊🍪💚🌳🌳💭
💭💭💭🌳🌳🌳🌳🌳🌳🌳🌳🙊🌳🍪🍪🍪🍪🍪💚🙊🌳🌳🌳🌳💚🌳💚🌳🌳🌳🌳💭💭🍪🍪🍪🍪🌚🌳🌳
💭💭🌳💚🌳🌳🌳🌚🌳🌳🌳🌳💚💚🍪🍪🍪🍪🍪🌚💚💚🌚🌳🌳🍪🍪🌳🌳🌳🌳💭💭🌳🍪🍪🍪🍪🌳🌳
💭🙊🌳🌳💚🌳🌳🌳🌳🌳💚🌳💚🍪🙊🌳🍪🍪🍪🍪🍪🙊🌳🌳💚🍪🌳🌳🌳🎀🌚🌳💭🌳🙊🍪🍪🌳🌳🌳
💭💭🌳🌳🌳🌳🌳🌳🌳🌳💚🌳🌳🌳🌳🍪🍪🍪🌳🌳🍪🍪💚💚🍪🍪🍪🌳🌚💚💚💼💭💭🌳🍪🍪💚💚🌳
💭💭🌳🌚💚🌳🌳🌳🌳...💚💭💭💭💭🙊🌳
💭💭💭💭💭💭💭💭💭💭💭💭💭💭💭💭💭💭🙊🍪🍪🍪🍪👕🌚🍪🍪🍪🌳🌳🍪🍪🌳🌳💭💭💭💭💚🌳
💭💭💭💭💭💭💭💭💭💭💭💭💭💭💭💭💭💭🍪🍪🍪🍪🍪🍪🍪🍪🍪🍪🍪🍪🌳🌳🌳💭💭💭🌳🌳🍪💭
💭💭💭💭💭💭💭💭💭💭💭💭💭💭💭💭💭💭🍪🍪🍪🍪🍪🍪🍪🍪🍪🍪🙊🌚🌳💭💭💭💭💭🌳🍪🍪💭
💭💭💭💭💭💭💭💭💭💭💭💭💭💭💭💭💭💭💭🍪🍪🍪🍪🍪🌚🍪🍪🍪🙊🌳🌳💭💭💭💭💭🌳🌚🌳💭
💭💭💭💭💭💭💭💭💭💭💭💭💭💭💭💭💭💭💭🌳🍪🍪🍪🍪🍪🍪🙊🍪🌳🌚🌳💭💭💭💭💭🌳🍪💭💭
💭💭💭💭💭💭💭💭💭💭💭💭💭💭💭💭💭💭💭🌳🍪🍪🍪🍪🌳🍪🍪🍪🌳🌳🌳💭💭💭💭💭🌳🌳💭💭
💭💭💭💭💭💭💭💭💭💭💭💭💭💭💭💭💭💭💭⚪💼🍪🌚🍪🍪🍪🍪🍪💼⚫💭💭💭💭💭💭💭💭🌕💭
💭💭💭💭💭💭💭💭💭💭💭💭💭💭💭💭💭💭💭💭🌚🍪🍪👕🍪🍪🍪🍪💼🌳🌕💭💭💭💭💭💭💭💭💭
💭💭💭💭💭💭💭💭💭💭💭💭💭💭💭💭💭💭💭💭💭🌳🍪🍪🍪💼🍪💼🍪💭💭💭💭💭💭💭💭💭💭💭
💭💭💭💭💭💭💭💭💭💭💭💭💭💭💭💭💭💭💭💭💭💭🍪🍪🍪🍪🍪🍪💭💭💭💭💭💭💭💭💭💭💭💭
💭💭💭💭💭💭💭💭💭💭💭💭💭💭💭💭💭💭💭💭💭🌳🌳🌳🍪🌳💭🌳💭💭💭💭💭💭💭💭💭💭💭💭
💭💭💭💭💭💭💭💭💭💭💭💭💭💭💭💭💭💭💭🌕💭💭🌳💭💭💭🌕🌚💭💭💭💭🐘🌕💭💭💭💭💭💭
